1 13 31
###############################
#p    b** *  1 * 2 *  * * *   #
# # # #t# # #*#*# # # #*#*#*# #
#  xf     s**  *      *   * * #
# # # # # #*# # #*#*# # # # #*#
#f           **  *  *         #
# # # # # # # # # #*# #*# # # #
#*  *      *  *      *        #
# # # # #*# # # #*#*# # # # # #
#*    **  *   2   *           #
# #*#2# # # # # #*# # # # # # #
#  3        *   *  *          #
###############################