1 13 31
###############################
#p    b** *  1 * 2 *  * * *   #
# # # #t# # #*#*# # # #*#*#*# #
#  xf     s**  *      *   * * #
# # # # # #*# # #*#*# # # # #*#
#f         x **  *  *         #
# # # # # # # # # #*# #*# # # #
#*  *      *  *      *        #
# # # # #*# # # #*#*# # # # # #
#*    **  *   2   *           #
# #*#2# # # # # #*# # # # # # #
#           *   *  *          #
###############################