1 13 31
###############################
#*                           *#
#  ************s************  #
#  *1 *   #         #   *  *  #
#  ****      **f**      ****  #
#  *         *   *         *  #
#  b         * p *      2  *  #
#  *         *   *         *  #
#  ****      **f**      ****  #
#  *  *   #         #   * 1*  #
#  ************b************  #
#x            2              b#
###############################