1 13 31
###############################
#*            1              *#
#  *************************  #
#  *1 *                 *  *  #
#  ****      **f**      ****  #
#  *         *   *         *  #
#  *  1      * p *      1  *  #
#  *         *   *         *  #
#  ****      **f**      ****  #
#  *  *                 * 1*  #
#  *************************  #
#x            1              *#
###############################