1 13 31
###############################
#p  f  ** *  1 * 2 *  * * *   #
# # # #*# # #*#*# # # #*#*#*# #
#  x*     ***  *  1   * 2 * * #
# # # # # #*# # #*#*# # # # #*#
#f  !      x ** 3*  *  *      #
# # # # # # # # # #*#*#*# # # #
#*  *      *  *  3   *   5    #
# # # # #*# # # #*#*# # # # # #
#*    ** 4 *      *      * *  #
# #*#*# # # # # #*# # # # # # #
#      4    *   *  *    5     #
###############################